{
		"ID":"6",
		"Width":"16",
		"Height":"50",
		"MapChip":[
		"1","0","0","0","0","0","0","0","0","0","0","0","0","0","1","7",
		"1","0","0","0","0","0","0","0","0","0","0","0","0","0","1","7",
		"1","0","0","0","0","0","0","0","0","0","0","0","0","0","1","7",
		"1","0","0","0","0","0","0","0","0","0","0","0","0","0","1","7",
		"1","0","0","0","0","0","0","0","0","0","1","1","1","1","1","7",
		"1","1","1","0","0","0","1","0","0","0","0","0","0","0","1","7",
		"1","1","1","0","0","0","1","0","0","0","0","0","0","0","1","7",
		"1","1","1","0","0","0","1","0","0","0","0","0","0","0","1","7",
		"1","1","1","0","0","0","1","0","0","0","0","0","0","0","1","7",
		"1","1","1","0","0","0","1","0","0","0","0","0","0","0","1","7",
		"1","0","0","0","0","0","0","0","0","1","4","4","4","4","1","7",
		"1","0","0","0","0","0","0","0","0","1","0","0","0","0","1","7",
		"1","0","0","0","0","0","0","0","0","1","0","0","0","0","1","7",
		"5","0","0","0","0","0","0","0","0","1","0","0","0","0","6","7",
		"1","0","0","0","0","0","0","0","0","1","0","0","0","0","1","7",
		"1","0","0","0","0","0","1","0","0","0","0","0","0","0","1","7",
		"1","0","0","0","0","0","1","0","0","0","0","0","0","0","1","7",
		"1","0","0","0","0","0","1","0","0","0","0","0","0","0","6","7",
		"5","0","0","0","0","0","1","0","0","0","0","0","0","0","1","7",
		"1","0","0","0","1","0","1","0","0","0","0","0","0","0","1","7",
		"1","0","0","0","1","0","0","0","0","0","1","0","0","0","6","7",
		"1","0","0","0","1","0","0","0","0","0","1","0","0","0","1","7",
		"5","0","0","0","1","0","0","0","0","0","1","0","0","0","1","7",
		"1","0","3","0","1","0","0","0","0","0","1","0","0","0","1","7",
		"2","0","1","0","0","0","0","0","0","0","1","0","0","0","1","7",
		"1","0","1","0","0","0","0","0","1","0","0","0","0","0","1","7",
		"1","0","1","0","0","0","0","0","1","0","0","0","0","0","1","7",
		"1","0","1","0","0","0","0","0","1","0","0","0","0","0","1","7",
		"1","0","1","0","0","0","0","3","1","0","0","0","1","0","1","7",
		"1","0","0","0","0","0","0","1","1","0","0","0","1","0","1","7",
		"1","0","0","0","0","0","0","0","1","0","0","0","1","0","1","7",
		"1","0","0","0","0","0","0","0","1","0","0","0","1","0","1","7",
		"1","0","0","0","0","0","0","3","1","0","0","0","1","0","6","7",
		"1","0","0","1","0","0","0","1","1","0","0","0","1","0","1","7",
		"1","0","0","1","0","0","0","1","1","0","0","0","0","0","1","7",
		"1","0","0","1","0","0","0","0","0","0","0","0","0","0","1","7",
		"1","0","0","1","1","0","0","0","0","0","0","0","0","0","1","7",
		"1","0","0","0","1","0","0","0","0","0","0","0","0","0","1","7",
		"5","0","0","0","1","0","1","0","0","0","0","0","0","0","1","7",
		"1","0","0","0","0","0","1","0","0","0","3","3","0","0","1","7",
		"1","0","0","0","0","0","1","4","4","1","1","1","1","0","1","7",
		"1","0","0","0","0","0","0","0","0","0","0","0","1","0","1","7",
		"5","0","0","0","0","0","0","0","0","0","0","0","1","0","1","7",
		"1","0","0","0","0","0","0","0","0","0","0","0","0","0","1","7",
		"1","0","0","3","0","0","0","0","0","0","0","0","0","0","1","7",
		"1","0","1","1","1","0","0","0","0","0","0","0","0","0","1","7",
		"1","0","0","0","0","0","0","0","0","0","0","0","0","3","1","7",
		"1","0","0","0","0","0","0","0","0","0","0","0","1","1","1","7",
		"1","0","0","0","0","0","0","0","0","0","0","0","0","0","1","7",
		"1","0","0","0","0","0","0","0","0","0","0","0","0","0","1","7"]
}