{
		"ID":"10",
		"Width":"16",
		"Height":"50",
		"MapChip":[
		"1","0","0","0","0","0","0","0","0","0","0","0","0","0","1","7",
		"1","1","0","0","0","0","0","0","0","0","0","0","0","0","1","7",
		"1","0","1","0","0","0","0","0","0","0","0","0","0","0","1","7",
		"1","0","1","0","0","0","0","0","0","0","0","0","0","0","1","7",
		"1","0","0","1","0","0","0","0","0","0","0","1","0","0","1","7",
		"1","0","0","1","0","0","0","0","0","0","1","0","0","0","1","7",
		"1","0","0","0","1","0","0","0","0","1","0","0","0","0","1","7",
		"1","0","0","0","1","0","0","0","1","0","0","0","0","0","1","7",
		"1","0","0","0","0","0","0","0","0","1","0","0","0","0","1","7",
		"1","0","0","0","0","0","0","0","0","0","1","0","0","0","1","7",
		"1","0","0","0","0","0","0","0","0","0","0","0","0","0","1","7",
		"1","0","0","0","0","0","0","0","1","1","1","0","0","0","1","7",
		"1","0","0","0","0","0","0","0","0","0","0","0","0","0","1","7",
		"1","0","0","1","1","0","0","0","0","0","0","0","0","0","1","7",
		"1","0","0","0","0","0","0","0","0","0","0","0","1","1","1","7",
		"1","0","0","0","0","0","1","1","0","0","0","0","0","0","1","7",
		"1","0","0","0","0","0","0","0","0","0","0","0","0","0","1","7",
		"1","1","1","0","0","0","0","0","0","0","0","0","0","0","1","7",
		"5","0","0","0","0","0","0","0","0","0","0","0","0","0","1","7",
		"1","0","0","0","0","0","0","0","0","0","0","0","0","0","1","7",
		"1","0","0","0","0","1","1","1","1","1","0","0","1","1","1","7",
		"1","0","0","0","0","0","0","0","0","0","0","0","0","0","1","7",
		"1","0","0","0","0","0","0","0","0","0","0","0","0","0","1","7",
		"1","0","0","0","0","0","0","0","0","0","0","0","0","0","1","7",
		"2","0","0","0","0","0","0","0","0","0","0","0","0","0","1","7",
		"1","0","0","0","0","0","0","0","0","0","0","0","0","0","1","7",
		"1","0","0","0","1","1","1","0","0","0","0","0","0","0","1","7",
		"1","0","0","0","0","0","0","0","0","1","1","1","1","1","1","7",
		"1","0","0","0","0","0","0","0","0","0","0","0","0","0","1","7",
		"1","0","0","0","0","0","0","0","0","0","0","0","0","0","1","7",
		"1","1","1","1","0","0","0","0","0","0","0","0","0","0","6","7",
		"5","0","0","0","0","0","0","0","0","0","0","0","0","0","1","7",
		"1","0","0","0","0","0","1","1","0","0","0","0","0","0","1","7",
		"1","0","0","0","0","0","0","0","0","0","0","0","0","0","1","7",
		"1","0","0","0","0","0","0","0","0","0","0","0","0","0","1","7",
		"1","0","0","0","0","0","0","0","0","0","0","0","0","0","6","7",
		"1","0","0","0","0","0","0","1","1","1","1","0","0","0","1","7",
		"1","0","0","0","0","0","0","0","0","0","0","0","0","0","1","7",
		"1","0","0","0","0","0","0","0","0","0","0","0","0","0","1","7",
		"1","0","0","4","4","4","0","0","0","0","0","1","1","0","1","7",
		"1","0","0","0","0","0","0","0","0","0","0","0","0","0","1","7",
		"1","0","3","3","0","0","0","0","0","0","0","0","0","0","1","7",
		"1","0","1","1","0","0","0","0","0","0","0","0","0","0","1","7",
		"1","0","0","0","0","0","0","0","0","0","0","0","0","0","1","7",
		"1","0","0","0","0","0","3","3","0","0","0","0","0","0","1","7",
		"1","0","0","0","1","1","1","1","1","1","0","0","0","0","1","7",
		"1","0","0","0","0","0","0","0","0","0","0","0","0","0","1","7",
		"1","0","0","0","0","0","0","0","0","0","0","0","0","1","6","7",
		"5","0","0","0","0","0","0","0","0","0","0","0","0","0","1","7",
		"1","0","0","0","0","0","0","0","0","0","0","0","0","0","1","7"]
}