{
		"ID":"1",
		"Width":"15",
		"Height":"50",
		"MapChip":[
		"1","0","0","0","0","0","0","0","0","0","0","0","0","0","1",
		"1","0","0","0","0","0","0","0","0","0","0","0","0","0","1",
		"1","0","0","0","0","0","0","0","0","0","0","0","0","0","1",
		"1","0","0","0","0","0","0","0","0","0","0","0","1","0","1",
		"1","1","1","1","0","0","0","0","0","0","0","1","0","0","1",
		"1","0","0","0","0","0","0","0","0","0","1","0","0","0","1",
		"1","0","0","0","1","1","1","0","0","1","0","0","0","0","1",
		"1","0","0","0","0","0","0","0","0","0","0","0","0","0","1",
		"1","0","0","0","0","0","0","0","0","0","0","0","0","0","1",
		"1","0","0","0","0","0","0","0","0","0","0","0","0","0","1",
		"1","1","1","0","1","0","0","0","0","0","0","0","1","0","1",
		"1","0","0","0","0","1","0","0","0","0","0","0","0","0","1",
		"1","0","0","0","0","0","1","0","0","1","1","0","0","0","1",
		"1","0","0","0","0","0","0","0","0","0","0","0","0","0","1",
		"1","0","0","0","0","0","0","0","0","0","0","0","0","0","1",
		"1","1","0","0","0","0","0","0","0","0","0","0","0","0","1",
		"1","0","1","0","0","0","0","0","0","0","0","0","0","0","6",
		"1","0","0","1","0","0","0","0","0","0","0","0","0","0","1",
		"1","0","0","0","1","3","0","0","0","0","0","0","0","0","1",
		"1","0","0","0","0","1","0","0","0","1","1","1","1","1","1",
		"1","0","0","0","0","0","0","0","0","0","0","0","0","0","1",
		"1","0","0","0","0","0","0","0","0","0","0","0","0","0","1",
		"1","0","0","0","1","0","0","0","0","0","0","0","0","0","1",
		"1","0","1","0","0","0","0","0","0","0","0","0","0","0","1",
		"2","0","0","0","0","0","0","0","0","0","0","0","0","1","1",
		"1","0","0","0","0","0","1","0","0","0","0","0","0","0","1",
		"1","1","1","0","0","0","0","0","0","0","1","0","0","0","1",
		"1","0","0","0","0","0","0","0","0","0","0","0","0","0","1",
		"1","0","0","0","0","3","0","0","0","0","0","0","0","0","1",
		"1","0","0","1","1","1","1","1","0","0","0","0","0","0","1",
		"1","0","0","0","0","0","0","0","0","0","0","0","0","0","6",
		"1","0","0","0","0","0","0","0","1","0","0","0","0","0","1",
		"1","0","0","0","0","0","0","0","1","0","0","0","0","0","1",
		"1","0","0","0","0","0","0","0","1","0","0","0","0","0","1",
		"1","0","0","0","0","0","0","0","1","0","0","0","0","0","1",
		"1","0","0","0","0","0","0","0","1","0","0","0","0","0","1",
		"1","0","0","0","0","0","0","0","1","0","0","1","0","0","1",
		"1","0","0","0","0","0","0","0","0","0","0","0","0","0","1",
		"1","1","1","1","1","1","0","0","0","0","0","0","0","0","1",
		"1","0","0","0","0","0","0","0","0","0","0","0","0","0","1",
		"1","0","0","0","0","0","0","0","0","0","0","0","0","0","1",
		"1","0","0","0","0","0","0","0","0","0","0","0","0","0","1",
		"1","0","0","0","0","0","0","0","0","0","0","0","0","0","1",
		"1","0","0","0","0","3","0","0","0","0","0","0","0","0","1",
		"1","0","0","1","1","1","1","1","0","0","0","1","1","0","1",
		"1","0","0","0","0","0","0","0","0","0","0","0","0","0","6",
		"1","0","0","0","0","0","0","0","0","0","0","0","0","0","1",
		"1","0","0","0","0","0","0","0","0","0","0","0","0","0","1",
		"1","1","1","4","4","1","1","4","4","1","1","4","4","1","1",
		"1","0","0","0","0","0","0","0","0","0","0","0","0","0","1"]
}