{
		"ID":"6",
		"Width":"15",
		"Height":"50",
		"MapChip":[
		"1","0","0","0","0","0","0","0","0","0","0","0","0","0","1",
		"1","0","0","0","0","0","0","0","0","0","0","0","0","0","1",
		"1","0","0","0","0","0","0","0","0","0","0","0","0","0","1",
		"1","0","0","0","0","0","0","0","0","0","0","0","0","0","1",
		"1","0","0","0","0","0","0","0","0","0","0","0","0","0","1",
		"1","0","0","0","0","0","0","0","0","0","0","0","0","0","1",
		"1","0","0","0","0","0","0","0","0","0","0","0","0","0","1",
		"1","0","0","0","0","0","0","0","0","0","0","0","0","0","1",
		"1","0","0","0","0","0","0","0","0","0","0","0","0","0","1",
		"1","0","0","0","0","0","0","0","0","0","0","0","0","0","1",
		"1","0","0","0","0","0","0","0","0","0","0","0","0","0","1",
		"1","0","0","0","0","0","0","0","0","0","0","0","0","0","1",
		"1","0","0","0","0","0","0","0","0","0","0","0","0","0","1",
		"1","0","0","0","0","0","0","0","0","0","0","0","0","0","1",
		"1","0","0","0","0","0","0","0","0","0","0","0","0","0","1",
		"1","0","0","0","0","0","0","0","0","0","0","0","0","0","1",
		"1","0","0","0","0","0","0","0","0","0","0","0","0","0","1",
		"1","0","0","0","0","0","0","0","0","0","0","0","0","0","1",
		"1","0","0","0","0","0","0","0","0","0","0","0","0","0","1",
		"1","0","0","0","0","0","0","0","0","0","0","0","0","0","1",
		"1","0","0","0","0","0","0","0","0","0","0","0","0","0","1",
		"1","0","0","0","0","0","0","0","0","0","0","0","0","0","1",
		"1","0","0","0","0","0","0","0","0","0","0","0","0","0","1",
		"1","0","0","0","0","0","0","0","0","0","0","0","0","0","1",
		"2","0","0","0","0","0","0","0","0","0","0","0","0","0","1",
		"1","0","0","0","0","0","0","0","0","0","0","0","0","0","1",
		"1","0","0","0","0","0","0","0","0","0","0","0","0","0","1",
		"1","0","0","0","0","0","0","0","0","0","0","0","0","0","1",
		"1","0","0","0","0","0","0","0","0","0","0","0","0","0","1",
		"1","0","0","0","0","0","0","0","0","0","0","0","0","0","1",
		"1","0","0","0","0","0","0","0","0","0","0","0","0","0","1",
		"1","0","0","0","0","0","0","0","0","0","0","0","0","0","1",
		"1","0","0","0","0","0","0","0","0","0","0","0","0","0","1",
		"1","0","0","0","0","0","0","0","0","0","0","0","0","0","1",
		"1","0","0","0","0","0","0","0","0","0","0","0","0","0","1",
		"1","0","0","0","0","0","0","0","0","0","0","0","0","0","1",
		"1","0","0","0","0","0","0","0","0","0","0","0","0","0","1",
		"1","0","0","0","0","0","0","0","0","0","0","0","0","0","1",
		"1","0","0","0","0","0","0","0","0","0","0","0","0","0","1",
		"1","0","0","0","0","0","0","0","0","0","0","0","0","0","1",
		"1","0","0","0","0","0","0","0","0","0","0","0","0","0","1",
		"1","0","0","0","0","0","0","0","0","0","0","0","0","0","1",
		"1","0","0","0","0","0","0","0","0","0","0","0","0","0","1",
		"1","0","0","0","0","0","0","0","0","0","0","0","0","0","1",
		"1","0","0","0","0","0","0","0","0","0","0","0","0","0","1",
		"1","0","0","0","0","0","0","0","0","0","0","0","0","0","1",
		"1","0","0","0","0","0","0","0","0","0","0","0","0","0","1",
		"1","0","0","0","0","0","0","0","0","0","0","0","0","0","1",
		"1","0","0","0","0","0","0","0","0","0","0","0","0","0","1",
		"1","0","0","0","0","0","0","0","0","0","0","0","0","0","1"]
}