{
		"ID":"3",
		"Width":"16",
		"Height":"50",
		"MapChip":[
		"1","0","0","0","0","0","0","0","0","0","0","0","0","0","1","7",
		"1","0","0","0","0","0","0","0","0","0","0","0","0","0","1","7",
		"1","1","0","0","0","0","0","0","0","0","0","0","0","0","1","7",
		"1","0","1","0","0","0","0","0","0","0","0","0","0","0","1","7",
		"1","0","1","0","0","0","0","0","0","0","0","0","0","1","1","7",
		"1","0","1","0","0","0","0","0","0","0","0","0","1","1","1","7",
		"1","0","0","1","0","0","0","0","0","0","0","1","1","0","1","7",
		"1","0","0","1","1","0","0","0","0","0","1","1","0","0","1","7",
		"1","0","0","0","0","0","0","0","0","0","0","0","0","0","1","7",
		"1","0","0","0","0","0","0","0","0","0","0","0","0","0","1","7",
		"1","0","0","0","0","0","0","0","0","0","0","0","0","0","1","7",
		"1","0","0","0","0","0","0","0","0","0","0","0","0","0","1","7",
		"1","0","0","0","0","1","1","1","1","1","0","0","0","0","1","7",
		"1","0","0","0","0","0","0","0","0","0","0","0","0","0","1","7",
		"1","0","0","0","0","0","0","0","0","0","0","0","0","0","1","7",
		"1","0","0","0","0","0","0","0","0","0","0","0","0","0","1","7",
		"1","0","0","0","0","0","0","0","0","1","1","0","0","0","1","7",
		"1","1","1","1","1","0","0","0","0","0","0","0","0","0","1","7",
		"1","0","0","0","0","0","0","0","0","0","0","0","0","0","1","7",
		"1","0","0","0","0","0","0","0","0","0","0","1","1","0","1","7",
		"1","0","0","0","0","0","1","1","0","0","0","0","0","0","1","7",
		"1","0","0","0","0","0","0","0","0","0","0","0","0","0","1","7",
		"1","0","0","0","0","0","0","0","0","0","0","0","0","0","1","7",
		"1","1","1","1","1","1","0","0","0","0","0","0","0","0","1","7",
		"2","0","0","0","0","0","0","0","0","0","0","0","0","0","1","7",
		"1","0","0","0","0","0","0","0","0","0","0","0","0","0","1","7",
		"1","0","0","0","0","0","1","1","0","0","0","0","0","0","1","7",
		"1","0","0","0","0","0","0","0","4","4","4","4","4","4","1","7",
		"1","0","0","0","0","1","1","0","0","0","0","0","0","0","1","7",
		"1","0","0","0","0","0","0","0","0","0","0","0","0","0","1","7",
		"1","0","0","0","0","0","0","0","0","0","0","0","0","0","1","7",
		"1","0","1","1","1","0","0","0","0","0","0","0","0","0","1","7",
		"1","0","0","0","0","0","0","0","0","0","0","0","0","0","1","7",
		"1","0","0","0","0","1","1","1","0","0","0","0","0","0","1","7",
		"1","0","0","0","0","0","0","0","0","0","0","0","0","0","1","7",
		"1","0","0","0","0","0","0","0","0","0","0","0","0","0","1","7",
		"1","0","0","0","0","0","0","0","1","1","1","1","0","0","1","7",
		"1","0","0","0","0","0","0","0","0","0","0","0","0","0","1","7",
		"1","0","0","0","0","0","0","0","0","0","0","0","0","0","1","7",
		"1","0","0","0","0","1","1","1","0","0","0","0","0","0","1","7",
		"1","0","0","0","0","0","0","0","0","0","0","0","0","0","1","7",
		"1","1","1","1","0","0","0","0","0","0","0","0","0","0","1","7",
		"1","0","0","0","0","0","0","0","0","0","0","0","0","0","1","7",
		"1","0","0","0","0","0","0","0","0","0","0","0","0","0","1","7",
		"1","0","0","0","0","0","1","1","0","0","0","0","0","0","1","7",
		"1","0","0","0","0","0","0","0","1","0","0","0","0","0","1","7",
		"1","0","0","0","0","0","0","0","0","4","4","4","4","4","1","7",
		"1","0","0","0","0","0","0","0","0","0","0","0","0","0","1","7",
		"1","0","0","1","0","1","1","0","0","0","0","1","0","0","1","7",
		"1","0","0","0","0","0","0","0","0","0","0","0","0","0","1","7"]
}