{
		"ID":"2",
		"Width":"7",
		"Height":"10",
		"MapChip":[
		"1","0","0","0","0","0","1",
		"1","0","0","0","0","0","1",
		"1","0","0","0","0","0","1",
		"1","0","0","0","0","0","1",
		"1","0","0","0","0","0","1",
		"2","0","0","0","0","0","1",
		"1","0","0","0","0","0","1",
		"1","0","0","0","0","0","1",
		"1","0","0","0","0","0","1",
		"1","0","0","0","0","0","1"]
}