{
		"ID":"1",
		"Width":"16",
		"Height":"50",
		"MapChip":[
		"1","0","0","0","0","0","0","0","0","0","0","0","0","0","6","7",
		"1","0","0","0","0","0","0","0","0","0","0","0","0","0","1","7",
		"5","0","0","0","0","0","0","0","0","0","0","0","0","0","1","7",
		"1","0","0","0","0","0","0","0","0","0","0","0","0","0","1","7",
		"1","0","0","0","0","0","0","0","0","0","0","0","0","0","1","7",
		"1","0","0","0","0","0","0","0","0","0","0","0","0","0","1","7",
		"1","0","0","0","0","0","0","0","0","0","0","0","0","0","1","7",
		"5","0","0","0","0","0","0","0","0","0","0","0","0","0","1","7",
		"1","0","0","0","0","0","0","0","0","0","0","0","0","0","6","7",
		"1","0","0","0","0","0","0","0","0","0","0","0","0","0","1","7",
		"1","0","0","0","0","0","0","0","0","0","0","0","0","0","1","7",
		"1","0","0","0","0","0","0","0","0","0","0","0","0","0","6","7",
		"5","0","0","0","0","0","0","0","0","0","0","0","0","0","1","7",
		"1","0","0","0","0","0","0","0","0","0","0","0","0","0","1","7",
		"1","0","0","0","0","0","0","0","0","0","0","0","0","0","6","7",
		"1","0","0","0","0","0","0","0","0","0","0","0","0","0","1","7",
		"1","0","0","0","0","0","0","0","0","0","0","0","0","0","1","7",
		"1","0","0","0","0","0","0","0","0","0","0","0","0","0","6","7",
		"1","0","0","0","0","0","0","0","0","0","0","0","0","0","1","7",
		"1","0","0","0","0","0","0","0","0","0","0","0","0","0","1","7",
		"5","0","0","0","0","0","0","0","0","0","0","0","0","0","1","7",
		"1","0","0","0","0","0","0","0","0","0","0","0","0","0","1","7",
		"5","0","0","0","0","0","0","0","0","0","0","0","0","0","1","7",
		"1","0","0","0","0","0","0","0","0","0","0","0","0","0","1","7",
		"2","0","0","0","0","0","0","0","0","0","0","0","0","0","1","7",
		"1","0","0","0","0","0","0","0","0","0","0","0","0","0","1","7",
		"1","0","0","0","0","0","0","0","0","0","0","0","0","0","6","7",
		"1","0","0","0","0","0","0","0","0","0","0","0","0","0","1","7",
		"1","0","0","0","0","0","0","0","0","0","0","0","0","0","1","7",
		"5","0","0","0","0","0","0","0","0","0","0","0","0","0","1","7",
		"1","0","0","0","0","0","0","0","0","0","0","0","0","0","6","7",
		"5","0","0","0","0","0","0","0","0","0","0","0","0","0","1","7",
		"1","0","0","0","0","0","0","0","0","0","0","0","0","0","1","7",
		"1","0","0","0","0","0","0","0","0","0","0","0","0","0","1","7",
		"5","0","0","0","0","0","0","0","0","0","0","0","0","0","1","7",
		"1","0","0","0","0","0","0","0","0","0","0","0","0","0","1","7",
		"1","0","0","0","0","0","0","0","0","0","0","0","0","0","1","7",
		"1","0","0","0","0","0","0","0","0","0","0","0","0","0","6","7",
		"1","0","0","0","0","0","0","0","0","0","0","0","0","0","1","7",
		"5","0","0","0","0","0","0","0","0","0","0","0","0","0","1","7",
		"1","0","0","0","0","0","0","0","0","0","0","0","0","0","1","7",
		"1","0","0","0","0","0","0","0","0","0","0","0","0","0","6","7",
		"1","0","0","0","0","0","0","0","0","0","0","0","0","0","1","7",
		"1","0","0","0","0","0","0","0","0","0","0","0","0","0","1","7",
		"5","0","0","0","0","0","0","0","0","0","0","0","0","0","6","7",
		"1","0","0","0","0","0","0","0","0","0","0","0","0","0","1","7",
		"1","0","0","0","0","0","0","0","0","0","0","0","0","0","1","7",
		"5","0","0","0","0","0","0","0","0","0","0","0","0","0","1","7",
		"1","0","0","0","0","0","0","0","0","0","0","0","0","0","1","7",
		"1","0","0","0","0","0","0","0","0","0","0","0","0","0","6","7"]
}